15
30
111111111111111
100000100000001
101110100111101
101000101000001
101011101010001
101000001001001
101011100001011
000000000010000
101100101110101
100000000000101
101011110110101
101000010000101
101010000111101
100000010000001
111111111111111
