9
50
111111111
100010001
101000101
100010001
001111100
100010001
101000101
100010001
111111111